8 8
........
........
...@....
@.......
........
.......@
@.@....@
@..@@...
5
0 7 2 5
1 4 5 3
2 7 1 7
3 0 7 3
4 5 1 2